10 6
EEEEOOEEEO
OOOEEEEOEO
EOEEOEOOOO
EOEOEEEEOO
EEEOOOOGOO
OOEEEEEEEO