10 6
EEEEOOEEEO
OOOEEEEOEO
EOEEOEOOOO
EOEOEEEEOO
EEEOOOOEOO
OOEEEEGEEO